9 9
...#..S.#
.#...##..
..####...
#..######
..##...##
#....#..G