10 20
#S##################
#..................#
#####...##########..
#.....#..##########.
......#...##.#......
.#####.###...#######
.#.........#........
...############...##
###.......##........
..G.#####....#######